XBeeApiFrame	KEYWORD1

AT_COMMAND	LITERAL1
AtCommand	KEYWORD1

AT_QUEUE_COMMAND	LITERAL1
AtQueueCommand	KEYWORD1

TX_REQUEST	LITERAL1
TxRequest	KEYWORD1

EXPLICIT_TX_REQUEST	LITERAL1
ExplicitTxRequest	KEYWORD1

REMOTE_AT_COMMAND	LITERAL1
RemoteAtCommand	KEYWORD1

AT_COMMAND_RESPONSE	LITERAL1
AtCommandResponse	KEYWORD1

MODEM_STATUS	LITERAL1
ModemStatus	KEYWORD1

TX_STATUS	LITERAL1
TxStatus	KEYWORD1

RX_RESPONSE	LITERAL1
RxResponse	KEYWORD1

EXPLICIT_RX_RESPONSE	LITERAL1
ExplicitRxResponse	KEYWORD1

RX_DATA_SAMPLE	LITERAL1
RxDataSample	KEYWORD1

RX_NODE_ID	LITERAL1
RxNodeId	KEYWORD1

REMOTE_AT_COMMAND_RESPONSE	LITERAL1
RemoteAtCommandResponse	KEYWORD1

XBee	KEYWORD1
readPacket	KEYWORD2
readPacketUntilAvailable	KEYWORD2
getApiFrame	KEYWORD2
setSerial	KEYWORD2
